3 44 27 17 42 10 26 50 
60 2 41 35 25 57 19 18 
1 51 52 59 58 49 11 34 
13 23 30 45 63 62 38 21 
31 12 14 55 20 47 29 54 
6 15 4 5 39 53 46 22 